
  | |   |   | | |   |   |   | |   |
  | |   |   | | |   |   |   | |   |
  | |   |   | | |   |   |   | |   |
  | +---+---+ | +---+---+---+ |   |
  |   |   |   |   |   |   |   |   |
  |   |   |   |   |   |   |   |   |
  +---+---+---+---+---+---+---+---+